PPPPPPPPPPPPPPPPPPPPPPPPPPPPPPPPPPPPPPPPPPPPPPPPPPPPPPP
Pkkkk                                                 P
Pkkkk                                                 P
P                                                     P
P                                                     P
P                                                     P
P                                                     P
P                                                     P
P                                                     P
P                                                     P
P                           P        PP      PP       P
P                           P                         P
P                           P                         P
P  S                        P                         P
PPPPPP         PP           PKKKKKKKKKKKKKKKKKK       P
PKKKKKKKKKKKKKKKKKKKKKKKKKKKPPPPPPPPPPPPPPPPPPP       P
PPPPPPPPPPPPPPPPPPPPPPPPPPPPPPPPPPPPPPPPPPPPPPP       P
P                                                     P
P                                                     P
P                                                     P
P                                                     P
P                                                     P
G                                                     P
G                                                     P
G                                                     P
G                                                     P
PPPPP           PP      PPPPPPPPPPPPPPPPPPPPPPPPPPPPPPP
P                       P    
PKKKKKKKKKKKKKKKKKKKKKKKP
PPPPPPPPPPPPPPPPPPPPPPPPP
