PPPPPPPPPPPPPPPPPPPPPPPPPPPPPPPPPPPPPPPP
P                                      P
P                                      P
P                                      P
P    S                                 P
P   PPPP                               P
P          PPPP           k   k        P
P                PPPP    PPPPPPP       P
P                                      P
P         PPPP                         P
P    k            k                    P
P   PPPP        PPPP                   P
P                                 PPPP P
P          PPPP          PPPP          P
P                                      P
P    PPPP          KKKK          PPPP  P
P                  PPPP                P
P           PPPP          PPPP         P
P                                      P
P      k            k            k     P
P    PPPP          PPPP         PPPP   P
P                                      P
P             PPPP        PPPP         P
P                                      P
P       PPPP        KKKK        PPPP   P
P                   PPPP               P
P  G                                   P
PPPPPPPPPPPPPPPPPPPPPPPPPPPPPPPPPPPPPPPP